######################
#....................#
#....................#
#....................#
#....................#
#..################..#
#....................#
#....................#
#....................#
#....................#
#....................#
######################