######################
#....................#
#.........#..........#
#.........#..........#
#.........#..........#
#..################..#
#.....#.........#....#
#.....#.........#....#
#.....#.........#....#
#....................#
#....................#
######################